10 10 8 8 8 8 8 9 8 8 8 8 8 10 10
10 10 8 0 0 0 0 8 0 0 0 0 8 10 10
8 8 8 0 9 0 0 8 0 0 9 0 8 8 8
8 0 0 9 12 9 0 8 0 9 12 9 0 0 8
8 0 0 0 9 0 0 8 0 0 9 0 0 0 8
8 8 0 0 0 0 0 10 0 0 0 0 0 0 8
10 10 8 8 8 8 8 10 8 8 8 8 8 10 10
8 8 0 0 0 0 0 8 0 0 0 0 0 0 8
8 0 0 0 9 0 0 8 0 0 9 0 0 0 8
8 0 0 9 12 9 0 8 0 9 12 9 0 0 8
8 8 8 0 9 0 0 8 0 0 9 0 8 8 8
10 10 8 0 0 0 0 8 0 0 0 0 8 10 10
10 10 8 8 8 8 8 9 8 8 8 8 8 10 10