10 10 10 10 10 10 10 10 10 10 10 10 10 10 10
10 10 10 10 10 10 10 10 10 10 10 10 10 10 10
10 10 10 10 10 10 10 10 10 10 10 10 10 10 10
10 10 10 10 10 10 10 10 10 10 10 10 10 10 10
10 0 0 0 13 0 0 0 0 0 13 0 0 0 10
10 0 14 14 14 14 14 0 14 14 14 14 14 0 10
10 0 13 0 14 0 13 0 13 0 14 0 13 0 10
10 14 14 14 14 14 14 14 14 14 14 14 14 14 10
10 13 13 13 13 13 13 13 13 13 13 13 13 13 10
10 0 14 0 13 0 14 0 14 0 13 0 14 0 10
10 0 13 0 14 0 13 0 13 0 14 0 13 0 10
10 0 0 13 14 13 0 0 0 13 14 13 0 0 10
10 10 10 10 10 10 10 10 10 10 10 10 10 10 10