30 30 30 30 30 30 30 30 30 30 30 30 30 30 30
30 30 30 30 30 30 30 30 30 30 30 30 30 30 30
30 30 30 30 30 30 30 30 30 30 30 30 30 30 30
30 30 30 30 30 30 30 30 30 30 30 30 30 30 30
30 30 30 30 23 30 30 30 30 30 22 30 30 30 30
30 30 22 30 23 30 24 30 30 21 25 30 30 30 30
30 30 30 30 21 30 22 30 23 30 22 30 30 30 30
30 23 21 30 25 30 30 22 30 23 30 30 24 30 30
30 23 22 30 30 21 30 25 30 24 30 21 30 24 30
30 30 23 30 23 30 24 30 22 30 30 30 25 30 30
30 30 22 30 24 30 23 30 23 30 30 30 23 30 30
30 30 30 24 30 22 30 30 30 22 23 30 30 30 30
30 30 30 30 30 30 30 30 30 30 30 30 30 30 30