5 4 5 4 0 0 0 4 0 0 0 4 5 4 5
4 7 4 0 6 6 6 0 6 6 6 0 4 7 4
5 4 0 6 0 5 0 6 0 4 0 6 0 4 5
4 0 6 0 4 5 4 5 4 5 4 0 6 0 4
5 0 6 4 5 4 5 4 5 4 5 4 6 0 5
4 0 6 0 4 5 11 11 11 5 4 0 6 0 4
5 0 6 4 5 4 11 11 11 4 5 4 6 0 5
4 5 0 6 0 5 4 5 4 5 0 6 0 5 4
5 4 5 0 6 4 5 4 5 4 6 0 5 4 5
4 5 4 5 0 6 0 0 0 6 0 5 4 5 4
5 4 0 4 5 0 6 0 6 0 5 4 0 4 5
4 7 0 5 4 5 0 6 0 5 4 5 0 7 4
5 0 0 4 5 4 5 4 5 4 5 4 0 0 5